NO ./images/n_bonus.xpm
SO ./images/s_bonus.xpm
WE ./images/w_bonus.xpm
EA ./images/e_bonus.xpm

C 0,   0,  0
F 0 , 0 , 0

        1111111111111111111111111
        1000000000110000000000001
        10110000011100000000000011111111111111111111111
        1001000000000000000000001
111111111011000001110000000000001
10000000001100000111011111O111111
11110111111111O11100000010001
11110111111111011101010010001
11000000110101011100000010001
10000000000000001100000010001
10000000000000000001010000001
110000011101010111110111100011
11110111 1110101 101111010N01
11111111 1111111 111111111111